##################################################
#A       #     #     #     #     #   #   #   #   #
# ###### # ### # ### # ### # ### # # # # # # # # #
# #    # #   #   #   # #   #   # # #   # #   #   #
# # ## # ##### # # ### # ##### # # ### # ####### #
#    # #       #               # # #   #     #   #
### # ####### ##### ##### ##### # # # ####### # ##
#   #     #   #     #     #     #   #   #     #  #
# ### ### # ### ##### ### ### ##### ### # ##### ##
# #     #   # # #     #   # #     #   # #     #  #
# # # # ##### # # ##### ### ##### # # ####### # ##
# # # # #     #   #   #   #   #   # #   #   # #  #
# # # ### # ### ##### ### # ### ### ### ### # # ##
# # #     # #       # #       # #     #   # # #  #
# # ####### # ##### # # ##### # # ### ### # # # ##
# #       # # #     # # #     # # #     #   # #  #
# ####### # ### ##### ### ### ### ##### ##### # ##
#     # # #       #     #   #     #     #     #  #
##### # # ####### ##### # ### ##### ##### ##### ##
#   #   # #   #     #   #     #       #   #      #
# # ##### # # # ### # ######### ##### # # ###### #
# #   #   # # # #   # #         #     # #        #
# ### # ### # # # # # ######### # ### # # #####  #
#     #     # #   # #   #   #   # # # # # #   #  #
### ##### ### ##### # # ### # ### # # # # # # #  #
#     #   #     #   # #     #     # #   # # #    #
# ### # ### ### ### ######### ##### # ### # ###  #
# # #   # #   #   # #       # #     # #   # #    #
# # # ### ### ##### # # # # # # ##### ### ### #  #
#   #       #     #   # # # #       #   #     #  #
### # ### ##### # ####### # ####### # # ##### ####
#   # # # #   # #       #       #   # # #     #  #
##### # ### # ##### ### ######### ##### # ### ####
#     #   # #     #   #     #   #   #   #   #    #
# ##### ### ##### ### ##### ### ### # # ### # # ##
#   #       #     #     # #     # # # #     # #  #
##### ### ##### ### ##### ##### # # # ####### ## #
#     #   #     #   #     #     # # #   #   #    #
# ####### ##### ### ##### ######### ##### ###  ###
# #     #   #     #   #     #     #   # #     #  #
# ### # ### # ### ##### ### ##### ### # ##### #  #
#   # #   # #     #     # #     #   #   #     #  #
### ##### # ####### ### # ### ### # ##### #####  #
# #     # # #   #   #   #   #   # # #   #     #  #
# ### # # ### # # # ### ### ### ##### ### #####  #
# #   # #     #   #     # # #     #     #   #    #
# # ####### ########### # # ##### # ### # ###  ###
#       #     #     #   #   #         #         B#
##################################################
