####################
##         # B     #
## ## # ########## #
#  #           ##  #
# ## ## ###### ## ##
     ## ######    ##
 ############## ####
###############  ###
#             ##   #
### ###  #### ## # #
#     #  ####    # #
### # ## ####### # #
### #    #### ## # #
### #### ##   ## # #
#     ## #  # ## # #
#######  # ## ##   #
##      ## ##    ###
## #### ## #  ## ###
##   A#    #   ##  #
####################
